11111111111111111111
11P00000CCCCCCC00001
11011111111111110001
11111110000CCC000011
11110000001001000001
1CE00000111111111111
11111111111111111111