111111111111111111111111
110001000100P00000111111
110011000C10001E00000111
111111111111111111111111