111111111111111111111111
1CE000000000000001111111
11000P000000000C00000011
111111111111111111111111