11111111111111111111
11P0000000C000000001
11111111111111110001
11111110000000111001
1111000000100100E011
10000001111111111111
11111111111111111111