11111111111111111111
10P0000000C000000001
10111111111111110001
10111110000000111001
1011000000100100E001
10000000000000000001
11111111111111111111