11111111111111111111
101000000C0000000001
1000111111111111C001
1010011000000011E101
1011C00000100100C101
1000000CC0000000P001
11111111111111111111