111111111111111111111
1100100C01111110C1111
1101010000P001010E011
111111111111111111111