11111111111111111111
11P00000CCCCCCC00001
11111111111111110001
11111110000CCC000011
10110000001000000001
11E10000111111111111
11111111111111111111